7 7
XXWXXXEXEXXXD
TXWXTXWXTXWXT
XXXXTXXXXXTXT
EXEXWXWXWXXXT
EXEXWXWXPXXXE
XXEXWXTXEXXXT
DXXXXXEXXXWXX
